90
0
13
0
5
3
2
-2
+F+X+F+C+
FXTXTXFXT
+F+C+F+T+
TXTXXXTXF
+F+F+F+T+