20
0
349
2
20
18
3
-1
+F+F+X+F+X+F+F+X+X+F+F+F+X+F+X+F+F+X+X+
FXXXFXXXFXFXFXXXFXFXFXXXFXXXFXFXFXXXFXF
+F+F+F+F+X+F+F+F+F+F+F+F+F+F+X+F+F+F+F+
TXXXFXXXFXFXXXFXXXXXXXXXFXXXFXFXXXFXXXT
+F+F+X+X+F+F+X+C+X+X+F+F+X+X+F+F+X+F+X+
FXXXXXXXFXXXFXXXFXXXFXXXTXXXFXXXFXXXFXX
+F+F+F+X+F+X+X+F+F+F+F+F+F+X+F+X+X+F+F+
XXTXXXXXFXFXXXFXXXXXXXXXTXXXFXFXXXFXXXT
+F+X+F+X+X+F+X+F+F+F+F+X+F+X+X+F+X+F+F+
FXFXXXFXXXFXFXXXFXFXFXFXXXFXXXFXFXXXFXC
+F+F+F+X+X+F+F+F+X+F+F+F+F+X+X+F+F+F+X+
FXTXXXFXFXXXXXXXXXFXFXXXXXFXFXXXXXXXXXF
+F+T+X+F+F+F+F+X+F+X+F+T+X+F+F+F+F+X+F+
XXXXFXFXXXFXXXFXXXFXXXXXFXFXXXFXXXFXXXF
+F+F+F+F+F+X+F+X+F+F+F+F+F+F+F+X+F+X+F+
FXFXXXXXFXXXFXXXFXFXFXFXXXXXFXXXFXXXFXF
+X+T+F+F+F+X+X+F+X+F+X+T+F+F+F+X+X+F+X+
FXXXXXFXFXXXFXXXFXXXXXFXXXXXXXXXXXFXXXF
+F+F+T+F+X+F+F+X+X+F+F+F+X+F+X+F+F+X+X+
FXXXFXXXFXFXFXXXFXFXFXXXFXXXFXFXFXXXFXF
+F+F+F+F+X+F+F+F+F+F+F+F+F+F+X+F+F+F+F+
XXXXFXXXFXFXXXFXXXXXXXXXFXXXFXFXXXFXXXX
+F+F+T+X+F+F+X+F+X+X+F+F+X+X+F+F+X+F+X+
FXXXXXTXFXXXFXXXFXXXFXXXTXXXFXXXFXXXFXX
+F+F+F+X+F+X+X+F+F+F+F+F+F+X+F+X+X+F+F+
XXXXTXXXFXFXXXFXXXTXXXXXXXXXFXFXXXFXXXX
+F+X+F+X+X+F+X+F+F+F+F+X+F+X+X+F+X+F+F+
FXFXXXFXXXFXFXXXFXFXFXFXXXFXXXFXFXXXFXF
+F+F+F+X+X+F+F+F+X+F+F+F+F+X+X+F+F+F+X+
FXXXXXFXFXXXXXTXXXFXFXXXTXFXFXXXTXXXXXF
+F+X+T+F+F+F+F+X+F+X+F+X+X+F+F+F+F+X+F+
XXXXFXFXXXFXXXFXXXFXXXXXFXFXXXFXXXFXXXF
+F+F+F+F+F+X+F+T+F+F+F+F+F+F+F+X+F+X+F+
FXFXXXTXFXXXFXXXFXFXFXFXXXXXFXXXFXXXFXF
+X+X+F+F+F+X+X+F+X+F+X+X+F+F+F+X+X+F+X+
