10
0
1393
1
39
36
1
-1
+F+F+X+F+X+F+F+X+X+F+F+F+X+F+X+F+F+X+X+F+F+X+F+X+F+F+X+X+F+F+F+X+F+X+F+F+X+X+
FXXXFXXXFXFXFXXXFXFXFXXXFXXXFXFXFXXXFXFXXXFXXXFXFXFXXXFXFXFXXXFXXXFXFXFXXXFXF
+F+F+F+F+X+F+F+F+F+F+F+F+F+F+X+F+F+F+F+F+F+F+F+X+F+F+F+F+F+F+F+F+F+X+F+F+F+F+
TXXXFXXXFXFXXXFXXXXXXXXXFXXXFXFXXXFXXXTXXXFXXXFXFXXXFXXXXXXXXXFXXXFXFXXXFXXXT
+F+F+X+X+F+F+X+F+X+X+F+F+X+X+F+F+X+F+X+F+F+X+X+F+F+X+F+X+X+F+F+X+X+F+F+X+F+X+
FXXXXXXXFXXXFXXXFXXXFXXXTXXXFXXXFXXXFXXXXXXXFXXXFXXXFXXXFXXXTXXXFXXXFXXXFXXXX
+F+F+F+X+F+X+X+F+F+F+F+F+F+X+F+X+X+F+F+F+F+F+X+F+X+X+F+F+F+F+F+F+X+F+X+X+F+F+
XXTXXXXXFXFXXXFXXXXXXXXXTXXXFXFXXXFXXXTXTXXXXXFXFXXXFXXXXXXXXXTXXXFXFXXXFXXXT
+F+X+F+X+X+F+X+F+F+F+F+X+F+X+X+F+X+F+F+F+X+F+X+X+F+X+F+F+F+F+X+F+X+X+F+X+F+F+
FXFXXXFXXXFXFXXXFXFXFXFXXXFXXXFXFXXXFXFXFXXXFXXXFXFXXXFXFXFXFXXXFXXXFXFXXXFXF
+F+F+F+X+X+F+F+F+X+F+F+F+F+X+X+F+F+F+X+F+F+F+X+X+F+F+F+X+F+F+F+F+X+X+F+F+F+X+
FXTXXXFXFXXXXXXXXXFXFXXXXXFXFXXXXXXXXXFXTXXXFXFXXXXXXXXXFXFXXXXXFXFXXXXXXXXXF
+F+T+X+F+F+F+F+X+F+X+F+T+X+F+F+F+F+X+F+F+T+X+F+F+F+F+X+F+X+F+T+X+F+F+F+F+X+F+
XXXXFXFXXXFXXXFXXXFXXXXXFXFXXXFXXXFXXXFXXXFXFXXXFXXXFXXXFXXXXXFXFXXXFXXXFXXXF
+F+F+F+F+F+X+F+X+F+F+F+F+F+F+F+X+F+X+F+F+F+F+F+F+X+F+X+F+F+F+F+F+F+F+X+F+X+F+
FXFXXXXXFXXXFXXXFXFXFXFXXXXXFXXXFXXXFXFXFXXXXXFXXXFXXXFXFXFXFXXXXXFXXXFXXXFXF
+X+T+F+F+F+X+X+F+X+F+X+T+F+F+F+X+X+F+X+X+T+F+F+F+X+X+F+X+F+X+T+F+F+F+X+X+F+X+
FXXXXXFXFXXXFXXXFXXXXXFXXXXXXXXXXXFXXXFXXXXXFXFXXXFXXXFXXXXXFXXXXXXXXXXXFXXXF
+F+F+T+F+X+F+F+X+X+F+F+F+X+F+X+F+F+X+X+F+F+T+F+X+F+F+X+X+F+F+F+X+F+X+F+F+X+X+
FXXXFXXXFXFXFXXXFXFXFXXXFXXXFXFXFXXXFXFXXXFXXXFXFXFXXXFXFXFXXXFXXXFXFXFXXXFXF
+F+F+F+F+X+F+F+F+F+F+F+F+F+F+X+F+F+F+F+F+F+F+F+X+F+F+F+F+F+F+F+F+F+X+F+F+F+F+
XXXXFXXXFXFXXXFXXXXXXXXXFXXXFXFXXXFXXXXXFXXXFXFXXXFXXXXXXXXXFXXXFXFXXXFXXXXXX
+F+F+T+X+F+F+X+F+X+X+F+F+X+X+F+F+X+F+X+F+F+T+X+F+F+X+F+X+X+F+F+X+X+F+F+X+F+X+
FXXXXXTXFXXXFXXXFXXXFXXXTXXXFXXXFXXXFXXXXXXXTXFXXXFXXXFXXXFXXXTXXXFXXXFXXXFXX
+F+F+F+X+F+X+X+F+F+F+F+F+F+X+F+X+X+F+F+F+F+F+X+F+X+X+F+F+F+F+F+F+X+F+X+X+F+F+
XXXXTXXXFXFXXXFXXXTXXXXXXXXXFXFXXXFXXXXXXXTXXXFXFXXXFXXXTXXXXXXXXXFXFXXXFXXXX
+F+X+F+X+X+F+X+F+F+F+F+X+F+X+X+F+X+F+F+F+X+F+X+X+F+X+F+F+F+F+X+F+X+X+F+X+F+F+
FXFXXXFXXXFXFXXXFXFXFXFXXXFXXXFXFXXXFXFXFXXXFXXXFXFXXXFXFXFXFXXXFXXXFXFXXXFXF
+F+F+F+X+X+F+F+F+X+F+F+F+F+X+X+F+F+F+X+F+F+F+X+X+F+F+F+X+F+F+F+F+X+X+F+F+F+X+
FXXXXXFXFXXXXXTXXXFXFXXXTXFXFXXXTXXXXXFXXXXXFXFXXXXXTXXXFXFXXXTXFXFXXXTXXXXXF
+F+X+T+F+F+F+F+X+F+X+F+X+X+F+F+F+F+X+F+F+X+T+F+F+F+F+X+F+X+F+X+X+F+F+F+F+X+F+
XXXXFXFXXXFXXXFXXXFXXXXXFXFXXXFXXXFXXXFXXXFXFXXXFXXXFXXXFXXXXXFXFXXXFXXXFXXXF
+F+F+F+F+F+X+F+T+F+F+F+F+F+F+F+X+F+X+F+F+F+F+F+F+X+F+T+F+F+F+F+F+F+F+X+F+X+F+
FXFXXXTXFXXXFXXXFXFXFXFXXXXXFXXXFXXXFXFXFXXXTXFXXXFXXXFXFXFXFXXXXXFXXXFXXXFXF
+X+X+F+F+F+X+X+F+X+F+X+X+F+F+F+X+X+F+X+X+X+F+F+F+X+X+F+X+F+X+X+F+F+F+X+X+F+X+
FXFXXXTXFXXXFXXXFXFXFXFXXXXXFXXXFXXXFXFXFXXXTXFXXXFXXXFXFXFXFXXXXXFXXXFXXXFXF
+F+F+X+F+X+F+F+X+X+F+F+F+X+F+X+F+F+X+X+F+F+X+F+X+F+F+X+X+F+F+F+X+F+X+F+F+X+X+
FXXXFXXXFXFXFXXXFXFXFXXXFXXXFXFXFXXXFXFXXXFXXXFXFXFXXXFXFXFXXXFXXXFXFXFXXXFXF
+F+F+F+F+X+F+F+F+F+F+F+F+F+F+X+F+F+F+F+F+F+F+F+X+F+F+F+F+F+F+F+F+F+X+F+F+F+F+
TXXXFXXXFXFXXXFXXXXXXXXXFXXXFXFXXXFXXXTXXXFXXXFXFXXXFXXXXXXXXXFXXXFXFXXXFXXXT
+F+F+X+X+F+F+X+F+X+X+F+F+X+X+F+F+X+F+X+F+F+X+X+F+F+X+F+X+X+F+F+X+X+F+F+X+F+X+
FXXXXXXXFXXXFXXXFXXXFXXXTXXXFXXXFXXXFXXXXXXXFXXXFXXXFXXXFXXXTXXXFXXXFXXXFXXXX
+F+F+F+X+F+X+X+F+F+F+F+F+F+X+F+X+X+F+F+F+F+F+X+F+X+X+F+F+F+F+F+F+X+F+X+X+F+F+
XXTXXXXXFXFXXXFXXXXXXXXXTXXXFXFXXXFXXXTXTXXXXXFXFXXXFXXXXXXXXXTXXXFXFXXXFXXXT
+F+X+F+X+X+F+X+F+F+F+F+X+F+X+X+F+X+F+F+F+X+F+X+X+F+X+F+F+F+F+X+F+X+X+F+X+F+F+
FXFXXXFXXXFXFXXXFXFXFXFXXXFXXXFXFXXXFXFXFXXXFXXXFXFXXXFXFXFXFXXXFXXXFXFXXXFXF
+F+F+F+X+X+F+F+F+X+F+F+F+F+X+X+F+F+F+X+F+F+F+X+X+F+F+F+X+F+F+F+F+X+X+F+F+F+X+
FXTXXXFXFXXXXXXXXXFXFXXXXXFXFXXXXXXXXXFXTXXXFXFXXXXXXXXXFXFXXXXXFXFXXXXXXXXXF
+F+T+X+F+F+F+F+X+F+X+F+T+X+F+F+F+F+X+F+F+T+X+F+F+F+F+X+F+X+F+T+X+F+F+F+F+X+F+
XXXXFXFXXXFXXXFXXXFXXXXXFXFXXXFXXXFXXXFXXXFXFXXXFXXXFXXXFXXXXXFXFXXXFXXXFXXXF
+F+F+F+F+F+X+F+X+F+F+F+F+F+F+F+X+F+X+F+F+F+F+F+F+X+F+X+F+F+F+F+F+F+F+X+F+X+F+
FXFXXXXXFXXXFXXXFXFXFXFXXXXXFXXXFXXXFXFXFXXXXXFXXXFXXXFXFXFXFXXXXXFXXXFXXXFXF
+X+T+F+F+F+X+X+F+X+F+X+T+F+F+F+X+X+F+X+X+T+F+F+F+X+X+F+X+F+X+T+F+F+F+X+X+F+X+
FXXXXXFXFXXXFXXXFXXXXXFXXXXXXXXXXXFXXXFXXXXXFXFXXXFXXXFXXXXXFXXXXXXXXXXXFXXXF
+F+F+T+F+X+F+F+X+X+F+F+F+X+F+X+F+F+X+X+F+F+T+F+X+F+F+X+X+F+F+F+X+F+X+F+F+X+X+
FXXXFXXXFXFXFXXXFXFXFXXXFXXXFXFXFXXXFXFXXXFXXXFXFXFXXXFXFXFXXXFXXXFXFXFXXXFXF
+F+F+F+F+X+F+F+F+F+F+F+F+F+F+X+F+F+F+F+F+F+F+F+X+F+F+F+F+F+F+F+F+F+X+F+F+F+F+
XXXXFXXXFXFXXXFXXXXXXXXXFXXXFXFXXXFXXXXXFXXXFXFXXXFXXXXXXXXXFXXXFXFXXXFXXXXXX
+F+F+T+X+F+F+X+F+X+X+F+F+X+X+F+F+X+F+X+F+F+T+X+F+F+X+F+X+X+F+F+X+X+F+F+X+F+X+
FXXXXXTXFXXXFXXXFXXXFXXXTXXXFXXXFXXXFXXXXXXXTXFXXXFXXXFXXXFXXXTXXXFXXXFXXXFXX
+F+F+F+X+F+X+X+F+F+F+F+F+F+X+F+X+X+F+F+F+F+F+X+F+X+X+F+F+F+F+F+F+X+F+X+X+F+F+
XXXXTXXXFXFXXXFXXXTXXXXXXXXXFXFXXXFXXXXXXXTXXXFXFXXXFXXXTXXXXXXXXXFXFXXXFXXXX
+F+X+F+X+X+F+X+F+F+F+F+X+F+X+X+F+X+F+F+F+X+F+X+X+F+X+F+F+F+F+X+F+X+X+F+X+F+F+
FXFXXXFXXXFXFXXXFXFXFXFXXXFXXXFXFXXXFXFXFXXXFXXXFXFXXXFXFXFXFXXXFXXXFXFXXXFXF
+F+F+F+X+X+F+F+F+X+F+F+F+F+X+X+F+F+F+X+F+F+F+X+X+F+F+F+X+F+F+F+F+X+X+F+F+F+X+
FXXXXXFXFXXXXXTXXXFXFXXXTXFXFXXXTXXXXXFXXXXXFXFXXXXXTXXXFXFXXXTXFXFXXXTXXXXXF
+F+X+T+F+F+F+F+X+F+X+F+X+X+F+F+F+F+X+F+F+X+T+F+F+F+F+X+F+X+F+X+X+F+F+F+F+X+F+
XXXXFXFXXXFXXXFXXXFXXXXXFXFXXXFXXXFXXXFXXXFXFXXXFXXXFXXXFXXXXXFXFXXXFXXXFXXXF
+F+F+F+F+F+X+F+T+F+F+F+F+F+F+F+X+F+X+F+F+F+F+F+F+X+F+T+F+F+F+F+F+F+F+X+F+X+F+
FXFXXXTXFXXXFXXXFXFXFXFXXXXXFXXXFXXXFXFXFXXXTXFXXXFXXXFXFXFXFXXXXXFXXXFXXXFXF
+X+X+F+F+F+X+X+F+X+F+X+X+F+F+F+X+X+F+X+X+X+F+F+F+X+X+F+X+F+X+X+F+F+F+X+X+F+X+
